instance,iterations,runtime_seconds,initial_cost,final_cost,improvement,pct_allocated,pct_not_allocated
s0m0.dat,1379,0.15037989616394043,445,495,-50,100.0,0.0
s0m1.dat,1379,0.15131568908691406,505,445,60,100.0,0.0
s0m2.dat,1379,0.13874220848083496,445,475,-30,100.0,0.0
s0m3.dat,1379,0.13675236701965332,455,465,-10,100.0,0.0
s100m0.dat,1379,0.13768649101257324,450,510,-60,100.0,0.0
s100m1.dat,1379,0.1816401481628418,410,540,-130,100.0,0.0
s100m2.dat,1379,0.14256715774536133,450,410,40,100.0,0.0
s100m3.dat,1379,0.17182421684265137,460,480,-20,100.0,0.0
s101m0.dat,1379,0.13972115516662598,545,555,-10,100.0,0.0
s101m1.dat,1379,0.13280105590820312,495,535,-40,100.0,0.0
s101m2.dat,1379,0.13280081748962402,555,515,40,100.0,0.0
s101m3.dat,1379,0.13094592094421387,415,515,-100,100.0,0.0
s102m0.dat,1379,0.11824250221252441,225,225,0,100.0,0.0
s102m1.dat,1379,0.09381723403930664,245,225,20,100.0,0.0
s102m2.dat,1379,0.09870505332946777,255,245,10,100.0,0.0
s102m3.dat,1379,0.10253334045410156,240,250,-10,100.0,0.0
s103m0.dat,1379,0.08396482467651367,340,285,55,100.0,0.0
s103m1.dat,1379,0.09086751937866211,220,220,0,100.0,0.0
s103m2.dat,1379,0.0868988037109375,350,285,65,100.0,0.0
s103m3.dat,1379,0.09081220626831055,250,300,-50,100.0,0.0
s104m0.dat,1379,0.1553483009338379,480,550,-70,100.0,0.0
s104m1.dat,1379,0.13864850997924805,520,590,-70,100.0,0.0
s104m2.dat,1379,0.12978887557983398,490,580,-90,100.0,0.0
s104m3.dat,1379,0.1504514217376709,540,520,20,100.0,0.0
s105m0.dat,1379,0.14452028274536133,560,530,30,100.0,0.0
s105m1.dat,1379,0.14451909065246582,540,610,-70,100.0,0.0
s105m2.dat,1379,0.14638948440551758,580,630,-50,100.0,0.0
s105m3.dat,1379,0.15729975700378418,640,550,90,100.0,0.0
s106m0.dat,1379,0.12019181251525879,395,405,-10,100.0,0.0
s106m1.dat,1379,0.1152496337890625,435,365,70,100.0,0.0
s106m2.dat,1379,0.11921262741088867,395,365,30,100.0,0.0
s106m3.dat,1379,0.16022944450378418,425,375,50,100.0,0.0
s107m0.dat,1379,0.18173003196716309,465,435,30,100.0,0.0
s107m1.dat,1379,0.14552569389343262,525,525,0,100.0,0.0
s107m2.dat,1379,0.14940142631530762,525,505,20,100.0,0.0
s107m3.dat,1379,0.14844822883605957,425,505,-80,100.0,0.0
s108m0.dat,1379,0.13574767112731934,720,630,90,100.0,0.0
s108m1.dat,1379,0.1376791000366211,580,730,-150,100.0,0.0
s108m2.dat,1379,0.1358201503753662,680,630,50,100.0,0.0
s108m3.dat,1379,0.13768339157104492,600,660,-60,100.0,0.0
s109m0.dat,1379,0.14655733108520508,685,625,60,100.0,0.0
s109m1.dat,1379,0.1621847152709961,645,675,-30,100.0,0.0
s109m2.dat,1379,0.14752984046936035,595,665,-70,100.0,0.0
s109m3.dat,1379,0.14845585823059082,635,675,-40,100.0,0.0
s10m0.dat,1379,0.13679814338684082,525,635,-110,100.0,0.0
s10m1.dat,1379,0.14744925498962402,545,545,0,100.0,0.0
s10m2.dat,1379,0.14842629432678223,565,625,-60,100.0,0.0
s10m3.dat,1379,0.14061856269836426,555,545,10,100.0,0.0
s110m0.dat,1379,0.12700939178466797,510,470,40,100.0,0.0
s110m1.dat,1379,0.12784838676452637,360,470,-110,100.0,0.0
s110m2.dat,1379,0.1171410083770752,510,450,60,100.0,0.0
s110m3.dat,1379,0.12507128715515137,460,420,40,100.0,0.0
s111m0.dat,1379,0.1767432689666748,545,475,70,100.0,0.0
s111m1.dat,1379,0.180649995803833,515,535,-20,100.0,0.0
s111m2.dat,1379,0.17381763458251953,465,585,-120,100.0,0.0
s111m3.dat,1379,0.13955211639404297,565,485,80,100.0,0.0
s112m0.dat,1379,0.17284941673278809,855,765,90,100.0,0.0
s112m1.dat,1379,0.1728372573852539,865,845,20,100.0,0.0
s112m2.dat,1379,0.17284393310546875,825,825,0,100.0,0.0
s112m3.dat,1379,0.1914370059967041,865,905,-40,100.0,0.0
s113m0.dat,1379,0.1464850902557373,495,545,-50,100.0,0.0
s113m1.dat,1379,0.1455838680267334,665,585,80,100.0,0.0
s113m2.dat,1379,0.1446080207824707,585,545,40,100.0,0.0
s113m3.dat,1379,0.14747977256774902,595,635,-40,100.0,0.0
s114m0.dat,1379,0.14549851417541504,530,570,-40,100.0,0.0
s114m1.dat,1379,0.1455841064453125,510,560,-50,100.0,0.0
s114m2.dat,1379,0.15827155113220215,580,600,-20,100.0,0.0
s114m3.dat,1379,0.14647245407104492,620,570,50,100.0,0.0
s115m0.dat,1379,0.12996792793273926,360,450,-90,100.0,0.0
s115m1.dat,1379,0.12595129013061523,350,320,30,100.0,0.0
s115m2.dat,1379,0.15047335624694824,460,340,120,100.0,0.0
s115m3.dat,1379,0.12694144248962402,420,350,70,100.0,0.0
s116m0.dat,1379,0.10554933547973633,300,395,-95,100.0,0.0
s116m1.dat,1379,0.11131644248962402,355,315,40,100.0,0.0
s116m2.dat,1379,0.11328268051147461,340,355,-15,100.0,0.0
s116m3.dat,1379,0.11326932907104492,345,385,-40,100.0,0.0
s117m0.dat,1379,0.15623831748962402,690,640,50,100.0,0.0
s117m1.dat,1379,0.15721464157104492,570,700,-130,100.0,0.0
s117m2.dat,1379,0.15625214576721191,670,630,40,100.0,0.0
s117m3.dat,1379,0.1552739143371582,630,670,-40,100.0,0.0
s118m0.dat,1379,0.12499284744262695,580,530,50,100.0,0.0
s118m1.dat,1379,0.13288664817810059,585,560,25,100.0,0.0
s118m2.dat,1379,0.12293863296508789,660,535,125,100.0,0.0
s118m3.dat,1379,0.1327369213104248,550,540,10,100.0,0.0
s119m0.dat,1379,0.11334037780761719,420,400,20,100.0,0.0
s119m1.dat,1379,0.11424732208251953,420,395,25,100.0,0.0
s119m2.dat,1379,0.11327600479125977,330,400,-70,100.0,0.0
s119m3.dat,1379,0.13565421104431152,380,400,-20,100.0,0.0
s11m0.dat,1379,0.1338651180267334,445,495,-50,100.0,0.0
s11m1.dat,1379,0.16402840614318848,465,495,-30,100.0,0.0
s11m2.dat,1379,0.13972115516662598,495,515,-20,100.0,0.0
s11m3.dat,1379,0.16212987899780273,475,505,-30,100.0,0.0
s120m0.dat,1379,0.12116813659667969,465,475,-10,100.0,0.0
s120m1.dat,1379,0.12205886840820312,495,465,30,100.0,0.0
s120m2.dat,1379,0.14753222465515137,495,435,60,100.0,0.0
s120m3.dat,1379,0.11913156509399414,435,435,0,100.0,0.0
s121m0.dat,1379,0.13184666633605957,455,445,10,100.0,0.0
s121m1.dat,1379,0.13386106491088867,475,505,-30,100.0,0.0
s121m2.dat,1379,0.15527009963989258,465,575,-110,100.0,0.0
s121m3.dat,1379,0.1309032440185547,505,555,-50,100.0,0.0
s122m0.dat,1379,0.10750198364257812,215,215,0,100.0,0.0
s122m1.dat,1379,0.10749697685241699,215,215,0,100.0,0.0
s122m2.dat,1379,0.10739898681640625,215,215,0,100.0,0.0
s122m3.dat,1379,0.10350275039672852,215,215,0,100.0,0.0
s123m0.dat,1379,0.09862184524536133,255,235,20,100.0,0.0
s123m1.dat,1379,0.0987091064453125,235,265,-30,100.0,0.0
s123m2.dat,1379,0.0996859073638916,210,275,-65,100.0,0.0
s123m3.dat,1379,0.11815690994262695,265,225,40,100.0,0.0
s124m0.dat,1379,0.15526032447814941,665,735,-70,100.0,0.0
s124m1.dat,1379,0.1669788360595703,695,685,10,100.0,0.0
s124m2.dat,1379,0.16600275039672852,725,695,30,100.0,0.0
s124m3.dat,1379,0.18268942832946777,705,595,110,100.0,0.0
s125m0.dat,1379,0.15526032447814941,405,625,-220,100.0,0.0
s125m1.dat,1379,0.13475513458251953,535,415,120,100.0,0.0
s125m2.dat,1379,0.186539888381958,435,505,-70,100.0,0.0
s125m3.dat,1379,0.17584562301635742,575,545,30,100.0,0.0
s126m0.dat,1379,0.11620140075683594,245,295,-50,100.0,0.0
s126m1.dat,1379,0.11620187759399414,295,275,20,100.0,0.0
s126m2.dat,1379,0.13768672943115234,315,255,60,100.0,0.0
s126m3.dat,1379,0.11327195167541504,245,275,-30,100.0,0.0
s127m0.dat,1379,0.1192162036895752,375,415,-40,100.0,0.0
s127m1.dat,1379,0.11030411720275879,415,335,80,100.0,0.0
s127m2.dat,1379,0.11820101737976074,335,425,-90,100.0,0.0
s127m3.dat,1379,0.1230168342590332,435,385,50,100.0,0.0
s128m0.dat,1379,0.13182353973388672,475,495,-20,100.0,0.0
s128m1.dat,1379,0.12801313400268555,565,495,70,100.0,0.0
s128m2.dat,1379,0.15729546546936035,445,465,-20,100.0,0.0
s128m3.dat,1379,0.16315031051635742,475,455,20,100.0,0.0
s129m0.dat,1379,0.19538044929504395,575,580,-5,100.0,0.0
s129m1.dat,1379,0.2226393222808838,615,565,50,100.0,0.0
s129m2.dat,1379,0.17088866233825684,645,570,75,100.0,0.0
s129m3.dat,1379,0.2168593406677246,615,560,55,100.0,0.0
s12m0.dat,1379,0.13670706748962402,345,415,-70,100.0,0.0
s12m1.dat,1379,0.1483900547027588,345,355,-10,100.0,0.0
s12m2.dat,1379,0.1688520908355713,365,445,-80,100.0,0.0
s12m3.dat,1379,0.15721607208251953,345,415,-70,100.0,0.0
s130m0.dat,1379,0.12595391273498535,455,355,100,100.0,0.0
s130m1.dat,1379,0.12801384925842285,435,445,-10,100.0,0.0
s130m2.dat,1379,0.13376998901367188,405,325,80,100.0,0.0
s130m3.dat,1379,0.13484716415405273,475,375,100,100.0,0.0
s131m0.dat,1379,0.13475513458251953,580,620,-40,100.0,0.0
s131m1.dat,1379,0.15137243270874023,640,550,90,100.0,0.0
s131m2.dat,1379,0.15032148361206055,610,640,-30,100.0,0.0
s131m3.dat,1379,0.1777644157409668,510,640,-130,100.0,0.0
s132m0.dat,1379,0.1406536102294922,410,300,110,100.0,0.0
s132m1.dat,1379,0.1074213981628418,325,330,-5,100.0,0.0
s132m2.dat,1379,0.10651469230651855,300,295,5,100.0,0.0
s132m3.dat,1379,0.11522483825683594,400,270,130,100.0,0.0
s133m0.dat,1379,0.2304551601409912,875,875,0,100.0,0.0
s133m1.dat,1379,0.21186232566833496,905,885,20,100.0,0.0
s133m2.dat,1379,0.22625970840454102,825,905,-80,100.0,0.0
s133m3.dat,1379,0.1894383430480957,825,885,-60,100.0,0.0
s134m0.dat,1379,0.09959602355957031,290,220,70,100.0,0.0
s134m1.dat,1379,0.12697434425354004,240,240,0,100.0,0.0
s134m2.dat,1379,0.09764814376831055,275,270,5,100.0,0.0
s134m3.dat,1379,0.10741257667541504,260,245,15,100.0,0.0
s135m0.dat,1379,0.16405415534973145,510,550,-40,100.0,0.0
s135m1.dat,1379,0.16796350479125977,560,490,70,100.0,0.0
s135m2.dat,1379,0.216780424118042,530,590,-60,100.0,0.0
s135m3.dat,1379,0.20612239837646484,520,510,10,100.0,0.0
s136m0.dat,1379,0.21066594123840332,680,680,0,100.0,0.0
s136m1.dat,1379,0.1747739315032959,655,695,-40,100.0,0.0
s136m2.dat,1379,0.17682313919067383,705,745,-40,100.0,0.0
s136m3.dat,1379,0.2021336555480957,745,735,10,100.0,0.0
s137m0.dat,1379,0.13678908348083496,595,495,100,100.0,0.0
s137m1.dat,1379,0.1874866485595703,525,555,-30,100.0,0.0
s137m2.dat,1379,0.16608881950378418,565,575,-10,100.0,0.0
s137m3.dat,1379,0.15233159065246582,515,635,-120,100.0,0.0
s138m0.dat,1379,0.13858509063720703,375,365,10,100.0,0.0
s138m1.dat,1379,0.14357423782348633,365,435,-70,100.0,0.0
s138m2.dat,1379,0.13670969009399414,405,395,10,100.0,0.0
s138m3.dat,1379,0.13084936141967773,335,405,-70,100.0,0.0
s139m0.dat,1379,0.1699817180633545,525,595,-70,100.0,0.0
s139m1.dat,1379,0.16511154174804688,525,475,50,100.0,0.0
s139m2.dat,1379,0.20604181289672852,455,535,-80,100.0,0.0
s139m3.dat,1379,0.16795873641967773,585,555,30,100.0,0.0
s13m0.dat,1379,0.15731310844421387,420,480,-60,100.0,0.0
s13m1.dat,1379,0.15629792213439941,410,410,0,100.0,0.0
s13m2.dat,1379,0.18659234046936035,380,420,-40,100.0,0.0
s13m3.dat,1379,0.1406114101409912,480,420,60,100.0,0.0
s140m0.dat,1379,0.11425304412841797,235,265,-30,100.0,0.0
s140m1.dat,1379,0.11522555351257324,235,245,-10,100.0,0.0
s140m2.dat,1379,0.115264892578125,265,235,30,100.0,0.0
s140m3.dat,1379,0.1035468578338623,235,235,0,100.0,0.0
s141m0.dat,1379,0.14841222763061523,230,230,0,100.0,0.0
s141m1.dat,1379,0.11820626258850098,230,230,0,100.0,0.0
s141m2.dat,1379,0.11716318130493164,230,230,0,100.0,0.0
s141m3.dat,1379,0.1143183708190918,310,230,80,100.0,0.0
s142m0.dat,1379,0.13191533088684082,355,325,30,100.0,0.0
s142m1.dat,1379,0.13481903076171875,305,345,-40,100.0,0.0
s142m2.dat,1379,0.13377785682678223,305,305,0,100.0,0.0
s142m3.dat,1379,0.16120362281799316,305,315,-10,100.0,0.0
s143m0.dat,1379,0.1982254981994629,495,485,10,100.0,0.0
s143m1.dat,1379,0.18170809745788574,515,585,-70,100.0,0.0
s143m2.dat,1379,0.22531986236572266,495,515,-20,100.0,0.0
s143m3.dat,1379,0.1777210235595703,555,525,30,100.0,0.0
s144m0.dat,1379,0.17090773582458496,565,550,15,100.0,0.0
s144m1.dat,1379,0.16312313079833984,620,570,50,100.0,0.0
s144m2.dat,1379,0.1640932559967041,605,580,25,100.0,0.0
s144m3.dat,1379,0.16307353973388672,550,660,-110,100.0,0.0
s145m0.dat,1379,0.12792158126831055,390,390,0,100.0,0.0
s145m1.dat,1379,0.12108898162841797,430,320,110,100.0,0.0
s145m2.dat,1379,0.14166831970214844,370,390,-20,100.0,0.0
s145m3.dat,1379,0.11922192573547363,400,350,50,100.0,0.0
s146m0.dat,1379,0.14256691932678223,375,385,-10,100.0,0.0
s146m1.dat,1379,0.1601402759552002,385,325,60,100.0,0.0
s146m2.dat,1379,0.14451980590820312,345,405,-60,100.0,0.0
s146m3.dat,1379,0.15330719947814941,325,325,0,100.0,0.0
s147m0.dat,1379,0.18367457389831543,425,465,-40,100.0,0.0
s147m1.dat,1379,0.15721607208251953,455,435,20,100.0,0.0
s147m2.dat,1379,0.16218161582946777,435,485,-50,100.0,0.0
s147m3.dat,1379,0.17961955070495605,535,425,110,100.0,0.0
s148m0.dat,1379,0.18740153312683105,775,825,-50,100.0,0.0
s148m1.dat,1379,0.17226338386535645,835,695,140,100.0,0.0
s148m2.dat,1379,0.18853521347045898,755,735,20,100.0,0.0
s148m3.dat,1379,0.1670541763305664,725,725,0,100.0,0.0
s149m0.dat,1379,0.25202107429504395,930,1020,-90,100.0,0.0
s149m1.dat,1379,0.25318121910095215,930,930,0,100.0,0.0
s149m2.dat,1379,0.23534393310546875,930,930,0,100.0,0.0
s149m3.dat,1379,0.23142766952514648,930,930,0,100.0,0.0
s14m0.dat,1379,0.16117215156555176,580,610,-30,100.0,0.0
s14m1.dat,1379,0.18756437301635742,550,620,-70,100.0,0.0
s14m2.dat,1379,0.14549541473388672,560,590,-30,100.0,0.0
s14m3.dat,1379,0.14451932907104492,560,580,-20,100.0,0.0
s150m0.dat,1379,0.1162862777709961,410,300,110,100.0,0.0
s150m1.dat,1379,0.12108469009399414,390,355,35,100.0,0.0
s150m2.dat,1379,0.12206077575683594,400,350,50,100.0,0.0
s150m3.dat,1379,0.12019014358520508,325,410,-85,100.0,0.0
s151m0.dat,1379,0.17381715774536133,540,570,-30,100.0,0.0
s151m1.dat,1379,0.14451861381530762,550,620,-70,100.0,0.0
s151m2.dat,1379,0.14939284324645996,540,530,10,100.0,0.0
s151m3.dat,1379,0.14063167572021484,610,580,30,100.0,0.0
s152m0.dat,1379,0.14354276657104492,500,600,-100,100.0,0.0
s152m1.dat,1379,0.14557838439941406,470,540,-70,100.0,0.0
s152m2.dat,1379,0.1455845832824707,530,560,-30,100.0,0.0
s152m3.dat,1379,0.17966175079345703,580,530,50,100.0,0.0
s153m0.dat,1379,0.14362382888793945,350,350,0,100.0,0.0
s153m1.dat,1379,0.14451932907104492,390,350,40,100.0,0.0
s153m2.dat,1379,0.1387467384338379,350,350,0,100.0,0.0
s153m3.dat,1379,0.14451813697814941,350,350,0,100.0,0.0
s154m0.dat,1379,0.18171334266662598,395,395,0,100.0,0.0
s154m1.dat,1379,0.1562187671661377,395,395,0,100.0,0.0
s154m2.dat,1379,0.15827655792236328,395,395,0,100.0,0.0
s154m3.dat,1379,0.15726470947265625,395,395,0,100.0,0.0
s155m0.dat,1379,0.09667706489562988,245,230,15,100.0,0.0
s155m1.dat,1379,0.09774398803710938,250,235,15,100.0,0.0
s155m2.dat,1379,0.0966649055480957,295,205,90,100.0,0.0
s155m3.dat,1379,0.0917963981628418,250,220,30,100.0,0.0
s156m0.dat,1379,0.1533210277557373,565,585,-20,100.0,0.0
s156m1.dat,1379,0.19626903533935547,605,585,20,100.0,0.0
s156m2.dat,1379,0.15625715255737305,485,545,-60,100.0,0.0
s156m3.dat,1379,0.15331435203552246,565,555,10,100.0,0.0
s157m0.dat,1379,0.15730071067810059,385,305,80,100.0,0.0
s157m1.dat,1379,0.1348438262939453,395,445,-50,100.0,0.0
s157m2.dat,1379,0.1318192481994629,455,375,80,100.0,0.0
s157m3.dat,1379,0.1328892707824707,385,375,10,100.0,0.0
s158m0.dat,1379,0.13182830810546875,325,375,-50,100.0,0.0
s158m1.dat,1379,0.12891316413879395,455,395,60,100.0,0.0
s158m2.dat,1379,0.1333301067352295,435,405,30,100.0,0.0
s158m3.dat,1379,0.13280081748962402,385,425,-40,100.0,0.0
s159m0.dat,1379,0.2208728790283203,640,730,-90,100.0,0.0
s159m1.dat,1379,0.18854260444641113,670,650,20,100.0,0.0
s159m2.dat,1379,0.18740248680114746,710,670,40,100.0,0.0
s159m3.dat,1379,0.1612076759338379,640,690,-50,100.0,0.0
s15m0.dat,1379,0.14159679412841797,485,465,20,100.0,0.0
s15m1.dat,1379,0.14744257926940918,435,505,-70,100.0,0.0
s15m2.dat,1379,0.14062213897705078,455,545,-90,100.0,0.0
s15m3.dat,1379,0.14159011840820312,465,485,-20,100.0,0.0
s160m0.dat,1379,0.17683696746826172,520,510,10,100.0,0.0
s160m1.dat,1379,0.14843153953552246,520,520,0,100.0,0.0
s160m2.dat,1379,0.14850878715515137,490,520,-30,100.0,0.0
s160m3.dat,1379,0.1435246467590332,470,590,-120,100.0,0.0
s161m0.dat,1379,0.20026469230651855,840,790,50,100.0,0.0
s161m1.dat,1379,0.2001805305480957,860,890,-30,100.0,0.0
s161m2.dat,1379,0.20125079154968262,850,790,60,100.0,0.0
s161m3.dat,1379,0.20026445388793945,810,800,10,100.0,0.0
s162m0.dat,1379,0.1319112777709961,395,425,-30,100.0,0.0
s162m1.dat,1379,0.13084864616394043,415,385,30,100.0,0.0
s162m2.dat,1379,0.13965344429016113,365,365,0,100.0,0.0
s162m3.dat,1379,0.13280153274536133,435,375,60,100.0,0.0
s163m0.dat,1379,0.15925812721252441,495,425,70,100.0,0.0
s163m1.dat,1379,0.165022611618042,455,475,-20,100.0,0.0
s163m2.dat,1379,0.14652180671691895,495,415,80,100.0,0.0
s163m3.dat,1379,0.1552588939666748,455,475,-20,100.0,0.0
s164m0.dat,1379,0.14554858207702637,360,380,-20,100.0,0.0
s164m1.dat,1379,0.1474449634552002,330,330,0,100.0,0.0
s164m2.dat,1379,0.1360313892364502,350,330,20,100.0,0.0
s164m3.dat,1379,0.1464996337890625,390,330,60,100.0,0.0
s165m0.dat,1379,0.11335492134094238,300,360,-60,100.0,0.0
s165m1.dat,1379,0.13280510902404785,350,280,70,100.0,0.0
s165m2.dat,1379,0.11522793769836426,390,290,100,100.0,0.0
s165m3.dat,1379,0.12592816352844238,320,300,20,100.0,0.0
s166m0.dat,1379,0.1826024055480957,700,680,20,100.0,0.0
s166m1.dat,1379,0.1777207851409912,710,740,-30,100.0,0.0
s166m2.dat,1379,0.1816272735595703,830,640,190,100.0,0.0
s166m3.dat,1379,0.17483949661254883,660,710,-50,100.0,0.0
s167m0.dat,1379,0.19245457649230957,525,465,60,100.0,0.0
s167m1.dat,1379,0.16014361381530762,495,515,-20,100.0,0.0
s167m2.dat,1379,0.1708085536956787,465,435,30,100.0,0.0
s167m3.dat,1379,0.1934983730316162,425,565,-140,100.0,0.0
s168m0.dat,1379,0.20221734046936035,770,730,40,100.0,0.0
s168m1.dat,1379,0.20630836486816406,710,700,10,100.0,0.0
s168m2.dat,1379,0.20213818550109863,680,720,-40,100.0,0.0
s168m3.dat,1379,0.23533225059509277,770,750,20,100.0,0.0
s169m0.dat,1379,0.16996407508850098,540,490,50,100.0,0.0
s169m1.dat,1379,0.14354228973388672,620,510,110,100.0,0.0
s169m2.dat,1379,0.16120672225952148,585,540,45,100.0,0.0
s169m3.dat,1379,0.15439295768737793,555,530,25,100.0,0.0
s16m0.dat,1379,0.15729880332946777,405,425,-20,100.0,0.0
s16m1.dat,1379,0.13775944709777832,445,485,-40,100.0,0.0
s16m2.dat,1379,0.13379979133605957,425,435,-10,100.0,0.0
s16m3.dat,1379,0.18363046646118164,425,495,-70,100.0,0.0
s170m0.dat,1379,0.10351252555847168,265,320,-55,100.0,0.0
s170m1.dat,1379,0.09383058547973633,250,250,0,100.0,0.0
s170m2.dat,1379,0.10545969009399414,265,235,30,100.0,0.0
s170m3.dat,1379,0.10740947723388672,205,245,-40,100.0,0.0
s171m0.dat,1379,0.12888574600219727,385,335,50,100.0,0.0
s171m1.dat,1379,0.11912894248962402,355,325,30,100.0,0.0
s171m2.dat,1379,0.11532735824584961,295,325,-30,100.0,0.0
s171m3.dat,1379,0.1211390495300293,275,335,-60,100.0,0.0
s172m0.dat,1379,0.09667038917541504,235,145,90,100.0,0.0
s172m1.dat,1379,0.10260701179504395,195,205,-10,100.0,0.0
s172m2.dat,1379,0.09577822685241699,155,245,-90,100.0,0.0
s172m3.dat,1379,0.09666061401367188,225,235,-10,100.0,0.0
s173m0.dat,1379,0.15233278274536133,480,490,-10,100.0,0.0
s173m1.dat,1379,0.14460539817810059,490,480,10,100.0,0.0
s173m2.dat,1379,0.14451074600219727,380,470,-90,100.0,0.0
s173m3.dat,1379,0.14450597763061523,460,480,-20,100.0,0.0
s174m0.dat,1379,0.17768454551696777,490,480,10,100.0,0.0
s174m1.dat,1379,0.20484113693237305,450,470,-20,100.0,0.0
s174m2.dat,1379,0.1728355884552002,420,440,-20,100.0,0.0
s174m3.dat,1379,0.16608476638793945,380,400,-20,100.0,0.0
s175m0.dat,1379,0.1640172004699707,520,520,0,100.0,0.0
s175m1.dat,1379,0.20604586601257324,550,490,60,100.0,0.0
s175m2.dat,1379,0.23736310005187988,500,510,-10,100.0,0.0
s175m3.dat,1379,0.18269681930541992,560,490,70,100.0,0.0
s176m0.dat,1379,0.18358254432678223,275,300,-25,100.0,0.0
s176m1.dat,1379,0.21677732467651367,280,290,-10,100.0,0.0
s176m2.dat,1379,0.1757957935333252,335,365,-30,100.0,0.0
s176m3.dat,1379,0.2149190902709961,320,265,55,100.0,0.0
s177m0.dat,1379,0.3614010810852051,485,485,0,100.0,0.0
s177m1.dat,1379,0.32036876678466797,515,455,60,100.0,0.0
s177m2.dat,1379,0.26568102836608887,525,485,40,100.0,0.0
s177m3.dat,1379,0.3100762367248535,445,395,50,100.0,0.0
s178m0.dat,1379,0.30590009689331055,435,525,-90,100.0,0.0
s178m1.dat,1379,0.2626972198486328,415,435,-20,100.0,0.0
s178m2.dat,1379,0.3369877338409424,405,455,-50,100.0,0.0
s178m3.dat,1379,0.23727726936340332,485,405,80,100.0,0.0
s179m0.dat,1379,0.23036527633666992,240,235,5,100.0,0.0
s179m1.dat,1379,0.16698050498962402,250,270,-20,100.0,0.0
s179m2.dat,1379,0.1923539638519287,285,295,-10,100.0,0.0
s179m3.dat,1379,0.24901270866394043,290,310,-20,100.0,0.0
s17m0.dat,1379,0.19911885261535645,230,250,-20,100.0,0.0
s17m1.dat,1379,0.15243816375732422,290,230,60,100.0,0.0
s17m2.dat,1379,0.17584729194641113,260,260,0,100.0,0.0
s17m3.dat,1379,0.20306873321533203,300,240,60,100.0,0.0
s180m0.dat,1379,0.2676420211791992,575,625,-50,100.0,0.0
s180m1.dat,1379,0.20516204833984375,535,625,-90,100.0,0.0
s180m2.dat,1379,0.2275247573852539,555,585,-30,100.0,0.0
s180m3.dat,1379,0.2531454563140869,585,575,10,100.0,0.0
s181m0.dat,1379,0.23777556419372559,775,765,10,100.0,0.0
s181m1.dat,1379,0.2666032314300537,755,735,20,100.0,0.0
s181m2.dat,1379,0.22284698486328125,795,825,-30,100.0,0.0
s181m3.dat,1379,0.26569032669067383,765,685,80,100.0,0.0
s182m0.dat,1379,0.25612378120422363,690,690,0,100.0,0.0
s182m1.dat,1379,0.25868916511535645,660,690,-30,100.0,0.0
s182m2.dat,1379,0.23177814483642578,650,740,-90,100.0,0.0
s182m3.dat,1379,0.22459030151367188,650,580,70,100.0,0.0
s183m0.dat,1379,0.15823006629943848,430,510,-80,100.0,0.0
s183m1.dat,1379,0.1582958698272705,450,410,40,100.0,0.0
s183m2.dat,1379,0.17975950241088867,410,470,-60,100.0,0.0
s183m3.dat,1379,0.16014766693115234,510,470,40,100.0,0.0
s184m0.dat,1379,0.17870235443115234,705,655,50,100.0,0.0
s184m1.dat,1379,0.1807410717010498,585,695,-110,100.0,0.0
s184m2.dat,1379,0.17969107627868652,705,605,100,100.0,0.0
s184m3.dat,1379,0.17476177215576172,615,655,-40,100.0,0.0
s185m0.dat,1379,0.1856400966644287,630,680,-50,100.0,0.0
s185m1.dat,1379,0.18367528915405273,650,680,-30,100.0,0.0
s185m2.dat,1379,0.18363523483276367,640,700,-60,100.0,0.0
s185m3.dat,1379,0.2382645606994629,600,700,-100,100.0,0.0
s186m0.dat,1379,0.16219568252563477,540,490,50,100.0,0.0
s186m1.dat,1379,0.1630713939666748,430,540,-110,100.0,0.0
s186m2.dat,1379,0.21881961822509766,550,490,60,100.0,0.0
s186m3.dat,1379,0.16102099418640137,510,490,20,100.0,0.0
s187m0.dat,1379,0.17187142372131348,375,425,-50,100.0,0.0
s187m1.dat,1379,0.1777195930480957,435,465,-30,100.0,0.0
s187m2.dat,1379,0.1738119125366211,505,345,160,100.0,0.0
s187m3.dat,1379,0.216780424118042,345,415,-70,100.0,0.0
s188m0.dat,1379,0.2246079444885254,415,325,90,100.0,0.0
s188m1.dat,1379,0.17097067832946777,345,405,-60,100.0,0.0
s188m2.dat,1379,0.15919089317321777,355,425,-70,100.0,0.0
s188m3.dat,1379,0.18073821067810059,355,345,10,100.0,0.0
s189m0.dat,1379,0.19926810264587402,315,295,20,100.0,0.0
s189m1.dat,1379,0.18748974800109863,305,315,-10,100.0,0.0
s189m2.dat,1379,0.19669771194458008,355,245,110,100.0,0.0
s189m3.dat,1379,0.20995306968688965,255,355,-100,100.0,0.0
s18m0.dat,1379,0.2930455207824707,650,700,-50,100.0,0.0
s18m1.dat,1379,0.2600216865539551,610,570,40,100.0,0.0
s18m2.dat,1379,0.27840256690979004,610,630,-20,100.0,0.0
s18m3.dat,1379,0.24039840698242188,600,560,40,100.0,0.0
s190m0.dat,1379,0.1865854263305664,495,505,-10,100.0,0.0
s190m1.dat,1379,0.24069690704345703,415,485,-70,100.0,0.0
s190m2.dat,1379,0.2030327320098877,475,485,-10,100.0,0.0
s190m3.dat,1379,0.23142790794372559,485,465,20,100.0,0.0
s191m0.dat,1379,0.2060394287109375,595,635,-40,100.0,0.0
s191m1.dat,1379,0.21686887741088867,725,625,100,100.0,0.0
s191m2.dat,1379,0.21589422225952148,685,585,100,100.0,0.0
s191m3.dat,1379,0.267533540725708,605,575,30,100.0,0.0
s192m0.dat,1379,0.23337483406066895,450,490,-40,100.0,0.0
s192m1.dat,1379,0.24920177459716797,530,480,50,100.0,0.0
s192m2.dat,1379,0.22361540794372559,480,450,30,100.0,0.0
s192m3.dat,1379,0.2812206745147705,570,480,90,100.0,0.0
s193m0.dat,1379,0.1982266902923584,445,395,50,100.0,0.0
s193m1.dat,1379,0.19725513458251953,395,395,0,100.0,0.0
s193m2.dat,1379,0.2227160930633545,395,395,0,100.0,0.0
s193m3.dat,1379,0.20025897026062012,395,395,0,100.0,0.0
s194m0.dat,1379,0.2520160675048828,405,405,0,100.0,0.0
s194m1.dat,1379,0.2541313171386719,405,405,0,100.0,0.0
s194m2.dat,1379,0.23151183128356934,415,465,-50,100.0,0.0
s194m3.dat,1379,0.2524223327636719,475,405,70,100.0,0.0
s195m0.dat,1379,0.3258988857269287,845,875,-30,100.0,0.0
s195m1.dat,1379,0.34177541732788086,895,845,50,100.0,0.0
s195m2.dat,1379,0.29516148567199707,845,895,-50,100.0,0.0
s195m3.dat,1379,0.2627582550048828,855,905,-50,100.0,0.0
s196m0.dat,1379,0.1934216022491455,320,250,70,100.0,0.0
s196m1.dat,1379,0.13572907447814941,360,360,0,100.0,0.0
s196m2.dat,1379,0.13182306289672852,250,370,-120,100.0,0.0
s196m3.dat,1379,0.13475561141967773,270,280,-10,100.0,0.0
s197m0.dat,1379,0.2832603454589844,865,935,-70,100.0,0.0
s197m1.dat,1379,0.2714564800262451,855,875,-20,100.0,0.0
s197m2.dat,1379,0.24998068809509277,785,915,-130,100.0,0.0
s197m3.dat,1379,0.31952619552612305,865,825,40,100.0,0.0
s198m0.dat,1379,0.27155303955078125,395,435,-40,100.0,0.0
s198m1.dat,1379,0.24121332168579102,415,365,50,100.0,0.0
s198m2.dat,1379,0.20400309562683105,405,365,40,100.0,0.0
s198m3.dat,1379,0.19733500480651855,345,475,-130,100.0,0.0
s199m0.dat,1379,0.18553471565246582,370,320,50,100.0,0.0
s199m1.dat,1379,0.16698026657104492,400,350,50,100.0,0.0
s199m2.dat,1379,0.18351268768310547,460,360,100,100.0,0.0
s199m3.dat,1379,0.17285585403442383,320,380,-60,100.0,0.0
s19m0.dat,1379,0.15827441215515137,285,255,30,100.0,0.0
s19m1.dat,1379,0.1504216194152832,285,325,-40,100.0,0.0
s19m2.dat,1379,0.14851975440979004,245,270,-25,100.0,0.0
s19m3.dat,1379,0.16901040077209473,275,240,35,100.0,0.0
s1m0.dat,1379,0.1855320930480957,390,500,-110,100.0,0.0
s1m1.dat,1379,0.1777195930480957,520,400,120,100.0,0.0
s1m2.dat,1379,0.178696870803833,400,460,-60,100.0,0.0
s1m3.dat,1379,0.20912408828735352,420,490,-70,100.0,0.0
s200m0.dat,1379,0.18363380432128906,505,485,20,100.0,0.0
s200m1.dat,1379,0.18456029891967773,575,485,90,100.0,0.0
s200m2.dat,1379,0.18552160263061523,545,535,10,100.0,0.0
s200m3.dat,1379,0.1845557689666748,445,515,-70,100.0,0.0
s201m0.dat,1379,0.16700267791748047,465,495,-30,100.0,0.0
s201m1.dat,1379,0.1670241355895996,415,465,-50,100.0,0.0
s201m2.dat,1379,0.1679549217224121,525,545,-20,100.0,0.0
s201m3.dat,1379,0.1679539680480957,415,495,-80,100.0,0.0
s202m0.dat,1379,0.22073578834533691,500,450,50,100.0,0.0
s202m1.dat,1379,0.20320940017700195,520,490,30,100.0,0.0
s202m2.dat,1379,0.15721344947814941,560,480,80,100.0,0.0
s202m3.dat,1379,0.15731549263000488,490,520,-30,100.0,0.0
s203m0.dat,1379,0.12694835662841797,275,290,-15,100.0,0.0
s203m1.dat,1379,0.1280043125152588,265,235,30,100.0,0.0
s203m2.dat,1379,0.12694120407104492,280,230,50,100.0,0.0
s203m3.dat,1379,0.1269218921661377,305,265,40,100.0,0.0
s204m0.dat,1379,0.1621851921081543,450,420,30,100.0,0.0
s204m1.dat,1379,0.159165620803833,430,460,-30,100.0,0.0
s204m2.dat,1379,0.15819048881530762,400,390,10,100.0,0.0
s204m3.dat,1379,0.15819907188415527,410,450,-40,100.0,0.0
s205m0.dat,1379,0.2080094814300537,760,790,-30,100.0,0.0
s205m1.dat,1379,0.20722293853759766,750,800,-50,100.0,0.0
s205m2.dat,1379,0.24607515335083008,760,810,-50,100.0,0.0
s205m3.dat,1379,0.2017374038696289,750,820,-70,100.0,0.0
s206m0.dat,1379,0.2060997486114502,510,480,30,100.0,0.0
s206m1.dat,1379,0.15333986282348633,510,470,40,100.0,0.0
s206m2.dat,1379,0.15526103973388672,510,510,0,100.0,0.0
s206m3.dat,1379,0.15916728973388672,530,470,60,100.0,0.0
s207m0.dat,1379,0.17972731590270996,520,440,80,100.0,0.0
s207m1.dat,1379,0.17487812042236328,470,520,-50,100.0,0.0
s207m2.dat,1379,0.163071870803833,560,420,140,100.0,0.0
s207m3.dat,1379,0.1494596004486084,520,510,10,100.0,0.0
s208m0.dat,1379,0.12604784965515137,275,270,5,100.0,0.0
s208m1.dat,1379,0.12401223182678223,265,280,-15,100.0,0.0
s208m2.dat,1379,0.12694144248962402,280,270,10,100.0,0.0
s208m3.dat,1379,0.12596631050109863,295,280,15,100.0,0.0
s209m0.dat,1379,0.11327147483825684,290,340,-50,100.0,0.0
s209m1.dat,1379,0.11522412300109863,280,340,-60,100.0,0.0
s209m2.dat,1379,0.11229586601257324,270,310,-40,100.0,0.0
s209m3.dat,1379,0.1133582592010498,260,320,-60,100.0,0.0
s20m0.dat,1379,0.16112732887268066,440,420,20,100.0,0.0
s20m1.dat,1379,0.16121149063110352,440,410,30,100.0,0.0
s20m2.dat,1379,0.16218256950378418,450,420,30,100.0,0.0
s20m3.dat,1379,0.16217827796936035,410,450,-40,100.0,0.0
s210m0.dat,1379,0.13670635223388672,445,415,30,100.0,0.0
s210m1.dat,1379,0.13573122024536133,465,375,90,100.0,0.0
s210m2.dat,1379,0.14069867134094238,435,435,0,100.0,0.0
s210m3.dat,1379,0.15033435821533203,375,455,-80,100.0,0.0
s211m0.dat,1379,0.10252881050109863,310,205,105,100.0,0.0
s211m1.dat,1379,0.13963627815246582,295,320,-25,100.0,0.0
s211m2.dat,1379,0.1347513198852539,285,285,0,100.0,0.0
s211m3.dat,1379,0.09862327575683594,255,265,-10,100.0,0.0
s212m0.dat,1379,0.15916681289672852,555,665,-110,100.0,0.0
s212m1.dat,1379,0.16209697723388672,645,565,80,100.0,0.0
s212m2.dat,1379,0.16305947303771973,665,725,-60,100.0,0.0
s212m3.dat,1379,0.16404962539672852,705,665,40,100.0,0.0
s213m0.dat,1379,0.14549970626831055,325,395,-70,100.0,0.0
s213m1.dat,1379,0.12987923622131348,405,395,10,100.0,0.0
s213m2.dat,1379,0.13865041732788086,385,375,10,100.0,0.0
s213m3.dat,1379,0.15912938117980957,335,355,-20,100.0,0.0
s214m0.dat,1379,0.16209697723388672,510,500,10,100.0,0.0
s214m1.dat,1379,0.17096877098083496,470,470,0,100.0,0.0
s214m2.dat,1379,0.14647912979125977,450,510,-60,100.0,0.0
s214m3.dat,1379,0.16600847244262695,510,450,60,100.0,0.0
s215m0.dat,1379,0.1474590301513672,620,620,0,100.0,0.0
s215m1.dat,1379,0.18357491493225098,710,540,170,100.0,0.0
s215m2.dat,1379,0.2343587875366211,650,620,30,100.0,0.0
s215m3.dat,1379,0.1650254726409912,620,580,40,100.0,0.0
s216m0.dat,1379,0.15143847465515137,585,505,80,100.0,0.0
s216m1.dat,1379,0.15046453475952148,605,525,80,100.0,0.0
s216m2.dat,1379,0.16600561141967773,445,565,-120,100.0,0.0
s216m3.dat,1379,0.19147658348083496,525,465,60,100.0,0.0
s217m0.dat,1379,0.12889456748962402,355,255,100,100.0,0.0
s217m1.dat,1379,0.1280040740966797,255,255,0,100.0,0.0
s217m2.dat,1379,0.15722441673278809,255,255,0,100.0,0.0
s217m3.dat,1379,0.12011265754699707,255,255,0,100.0,0.0
s218m0.dat,1379,0.15330815315246582,495,575,-80,100.0,0.0
s218m1.dat,1379,0.15825629234313965,585,475,110,100.0,0.0
s218m2.dat,1379,0.17780661582946777,545,595,-50,100.0,0.0
s218m3.dat,1379,0.1513528823852539,565,555,10,100.0,0.0
s219m0.dat,1379,0.25095605850219727,730,810,-80,100.0,0.0
s219m1.dat,1379,0.17869782447814941,770,720,50,100.0,0.0
s219m2.dat,1379,0.1650247573852539,790,750,40,100.0,0.0
s219m3.dat,1379,0.16707825660705566,810,750,60,100.0,0.0
s21m0.dat,1379,0.12889599800109863,330,480,-150,100.0,0.0
s21m1.dat,1379,0.14454078674316406,370,350,20,100.0,0.0
s21m2.dat,1379,0.1641392707824707,350,400,-50,100.0,0.0
s21m3.dat,1379,0.13280701637268066,360,390,-30,100.0,0.0
s220m0.dat,1379,0.1543281078338623,465,425,40,100.0,0.0
s220m1.dat,1379,0.16893768310546875,475,425,50,100.0,0.0
s220m2.dat,1379,0.16991305351257324,495,555,-60,100.0,0.0
s220m3.dat,1379,0.18545079231262207,525,455,70,100.0,0.0
s221m0.dat,1379,0.0987086296081543,240,270,-30,100.0,0.0
s221m1.dat,1379,0.0937354564666748,210,200,10,100.0,0.0
s221m2.dat,1379,0.09276652336120605,190,200,-10,100.0,0.0
s221m3.dat,1379,0.09569644927978516,250,200,50,100.0,0.0
s222m0.dat,1379,0.1913919448852539,570,510,60,100.0,0.0
s222m1.dat,1379,0.1728372573852539,460,565,-105,100.0,0.0
s222m2.dat,1379,0.19231200218200684,560,530,30,100.0,0.0
s222m3.dat,1379,0.16120648384094238,580,470,110,100.0,0.0
s223m0.dat,1379,0.12116599082946777,290,305,-15,100.0,0.0
s223m1.dat,1379,0.13084816932678223,295,285,10,100.0,0.0
s223m2.dat,1379,0.10741186141967773,305,255,50,100.0,0.0
s223m3.dat,1379,0.10545659065246582,295,285,10,100.0,0.0
s224m0.dat,1379,0.1299128532409668,185,185,0,100.0,0.0
s224m1.dat,1379,0.09666967391967773,185,185,0,100.0,0.0
s224m2.dat,1379,0.10253262519836426,185,185,0,100.0,0.0
s224m3.dat,1379,0.09374213218688965,185,185,0,100.0,0.0
s225m0.dat,1379,0.12402582168579102,405,455,-50,100.0,0.0
s225m1.dat,1379,0.13288497924804688,495,455,40,100.0,0.0
s225m2.dat,1379,0.1553480625152588,415,435,-20,100.0,0.0
s225m3.dat,1379,0.13377737998962402,435,505,-70,100.0,0.0
s226m0.dat,1379,0.14833879470825195,685,835,-150,100.0,0.0
s226m1.dat,1379,0.14943170547485352,685,695,-10,100.0,0.0
s226m2.dat,1379,0.1494138240814209,615,655,-40,100.0,0.0
s226m3.dat,1379,0.15233469009399414,695,735,-40,100.0,0.0
s227m0.dat,1379,0.12995266914367676,395,385,10,100.0,0.0
s227m1.dat,1379,0.12987327575683594,335,365,-30,100.0,0.0
s227m2.dat,1379,0.13475537300109863,335,345,-10,100.0,0.0
s227m3.dat,1379,0.1338655948638916,315,385,-70,100.0,0.0
s228m0.dat,1379,0.11231088638305664,285,265,20,100.0,0.0
s228m1.dat,1379,0.11531615257263184,315,265,50,100.0,0.0
s228m2.dat,1379,0.11328959465026855,265,265,0,100.0,0.0
s228m3.dat,1379,0.11417460441589355,265,265,0,100.0,0.0
s229m0.dat,1379,0.13182830810546875,425,415,10,100.0,0.0
s229m1.dat,1379,0.15046143531799316,495,495,0,100.0,0.0
s229m2.dat,1379,0.1620960235595703,455,395,60,100.0,0.0
s229m3.dat,1379,0.14452457427978516,395,385,10,100.0,0.0
s22m0.dat,1379,0.11815428733825684,305,235,70,100.0,0.0
s22m1.dat,1379,0.11530947685241699,320,255,65,100.0,0.0
s22m2.dat,1379,0.12011218070983887,275,305,-30,100.0,0.0
s22m3.dat,1379,0.1142432689666748,265,290,-25,100.0,0.0
s230m0.dat,1379,0.10746383666992188,235,235,0,100.0,0.0
s230m1.dat,1379,0.10839629173278809,235,235,0,100.0,0.0
s230m2.dat,1379,0.10927510261535645,235,235,0,100.0,0.0
s230m3.dat,1379,0.09968352317810059,245,235,10,100.0,0.0
s231m0.dat,1379,0.12011075019836426,280,280,0,100.0,0.0
s231m1.dat,1379,0.12401270866394043,280,310,-30,100.0,0.0
s231m2.dat,1379,0.13389015197753906,280,290,-10,100.0,0.0
s231m3.dat,1379,0.1220560073852539,280,300,-20,100.0,0.0
s232m0.dat,1379,0.20514130592346191,610,590,20,100.0,0.0
s232m1.dat,1379,0.1728382110595703,580,590,-10,100.0,0.0
s232m2.dat,1379,0.1962740421295166,630,530,100,100.0,0.0
s232m3.dat,1379,0.20015859603881836,680,600,80,100.0,0.0
s233m0.dat,1379,0.13378405570983887,475,435,40,100.0,0.0
s233m1.dat,1379,0.13865923881530762,445,375,70,100.0,0.0
s233m2.dat,1379,0.1387341022491455,545,395,150,100.0,0.0
s233m3.dat,1379,0.13866043090820312,415,445,-30,100.0,0.0
s234m0.dat,1379,0.1348586082458496,320,280,40,100.0,0.0
s234m1.dat,1379,0.11229515075683594,260,350,-90,100.0,0.0
s234m2.dat,1379,0.11425948143005371,280,250,30,100.0,0.0
s234m3.dat,1379,0.13288426399230957,240,320,-80,100.0,0.0
s235m0.dat,1379,0.14940571784973145,485,495,-10,100.0,0.0
s235m1.dat,1379,0.15045905113220215,575,435,140,100.0,0.0
s235m2.dat,1379,0.14842677116394043,445,495,-50,100.0,0.0
s235m3.dat,1379,0.17487764358520508,515,515,0,100.0,0.0
s236m0.dat,1379,0.1348416805267334,535,565,-30,100.0,0.0
s236m1.dat,1379,0.13670849800109863,595,585,10,100.0,0.0
s236m2.dat,1379,0.12695789337158203,535,445,90,100.0,0.0
s236m3.dat,1379,0.13963699340820312,465,495,-30,100.0,0.0
s237m0.dat,1379,0.15326380729675293,435,435,0,100.0,0.0
s237m1.dat,1379,0.15040802955627441,405,435,-30,100.0,0.0
s237m2.dat,1379,0.13971829414367676,375,475,-100,100.0,0.0
s237m3.dat,1379,0.16014766693115234,435,415,20,100.0,0.0
s238m0.dat,1379,0.16208887100219727,505,495,10,100.0,0.0
s238m1.dat,1379,0.13768339157104492,365,455,-90,100.0,0.0
s238m2.dat,1379,0.13866257667541504,415,455,-40,100.0,0.0
s238m3.dat,1379,0.14062952995300293,445,435,10,100.0,0.0
s239m0.dat,1379,0.14061331748962402,465,495,-30,100.0,0.0
s239m1.dat,1379,0.14451932907104492,455,525,-70,100.0,0.0
s239m2.dat,1379,0.12993931770324707,465,475,-10,100.0,0.0
s239m3.dat,1379,0.14163923263549805,425,475,-50,100.0,0.0
s23m0.dat,1379,0.12695670127868652,350,390,-40,100.0,0.0
s23m1.dat,1379,0.11816143989562988,360,350,10,100.0,0.0
s23m2.dat,1379,0.1084756851196289,270,250,20,100.0,0.0
s23m3.dat,1379,0.11620116233825684,350,270,80,100.0,0.0
s240m0.dat,1379,0.16791462898254395,545,545,0,100.0,0.0
s240m1.dat,1379,0.17967438697814941,605,655,-50,100.0,0.0
s240m2.dat,1379,0.19829320907592773,475,515,-40,100.0,0.0
s240m3.dat,1379,0.18161892890930176,525,635,-110,100.0,0.0
s241m0.dat,1379,0.18260431289672852,635,545,90,100.0,0.0
s241m1.dat,1379,0.21384572982788086,615,655,-40,100.0,0.0
s241m2.dat,1379,0.17186188697814941,615,525,90,100.0,0.0
s241m3.dat,1379,0.18748998641967773,645,565,80,100.0,0.0
s242m0.dat,1379,0.15144920349121094,500,600,-100,100.0,0.0
s242m1.dat,1379,0.16216754913330078,430,580,-150,100.0,0.0
s242m2.dat,1379,0.14745044708251953,580,630,-50,100.0,0.0
s242m3.dat,1379,0.19529938697814941,500,580,-80,100.0,0.0
s243m0.dat,1379,0.1777195930480957,815,815,0,100.0,0.0
s243m1.dat,1379,0.17487025260925293,845,735,110,100.0,0.0
s243m2.dat,1379,0.21697211265563965,805,775,30,100.0,0.0
s243m3.dat,1379,0.18846702575683594,755,815,-60,100.0,0.0
s244m0.dat,1379,0.16103172302246094,545,575,-30,100.0,0.0
s244m1.dat,1379,0.1885361671447754,555,535,20,100.0,0.0
s244m2.dat,1379,0.17186212539672852,595,475,120,100.0,0.0
s244m3.dat,1379,0.17479777336120605,595,565,30,100.0,0.0
s245m0.dat,1379,0.20806431770324707,665,565,100,100.0,0.0
s245m1.dat,1379,0.16014432907104492,525,565,-40,100.0,0.0
s245m2.dat,1379,0.16795563697814941,515,565,-50,100.0,0.0
s245m3.dat,1379,0.166978120803833,565,545,20,100.0,0.0
s246m0.dat,1379,0.14745259284973145,395,345,50,100.0,0.0
s246m1.dat,1379,0.15037822723388672,365,345,20,100.0,0.0
s246m2.dat,1379,0.17582273483276367,385,385,0,100.0,0.0
s246m3.dat,1379,0.15047574043273926,375,385,-10,100.0,0.0
s247m0.dat,1379,0.14159131050109863,200,205,-5,100.0,0.0
s247m1.dat,1379,0.1933460235595703,200,195,5,100.0,0.0
s247m2.dat,1379,0.19823098182678223,200,205,-5,100.0,0.0
s247m3.dat,1379,0.1982250213623047,205,205,0,100.0,0.0
s248m0.dat,1379,0.2529144287109375,520,585,-65,100.0,0.0
s248m1.dat,1379,0.281233549118042,560,610,-50,100.0,0.0
s248m2.dat,1379,0.22645998001098633,680,520,160,100.0,0.0
s248m3.dat,1379,0.1865088939666748,470,650,-180,100.0,0.0
s249m0.dat,1379,0.14061331748962402,545,475,70,100.0,0.0
s249m1.dat,1379,0.1387472152709961,500,485,15,100.0,0.0
s249m2.dat,1379,0.15046453475952148,485,475,10,100.0,0.0
s249m3.dat,1379,0.13577961921691895,555,395,160,100.0,0.0
s24m0.dat,1379,0.18358349800109863,495,505,-10,100.0,0.0
s24m1.dat,1379,0.16504168510437012,465,605,-140,100.0,0.0
s24m2.dat,1379,0.21190357208251953,445,515,-70,100.0,0.0
s24m3.dat,1379,0.19245004653930664,525,535,-10,100.0,0.0
s25m0.dat,1379,0.14638900756835938,445,445,0,100.0,0.0
s25m1.dat,1379,0.15924954414367676,395,445,-50,100.0,0.0
s25m2.dat,1379,0.15923762321472168,425,525,-100,100.0,0.0
s25m3.dat,1379,0.15819287300109863,445,415,30,100.0,0.0
s26m0.dat,1379,0.1494274139404297,280,310,-30,100.0,0.0
s26m1.dat,1379,0.13191819190979004,280,280,0,100.0,0.0
s26m2.dat,1379,0.1328721046447754,280,300,-20,100.0,0.0
s26m3.dat,1379,0.1220555305480957,280,310,-30,100.0,0.0
s27m0.dat,1379,0.15819573402404785,740,810,-70,100.0,0.0
s27m1.dat,1379,0.1874556541442871,840,730,110,100.0,0.0
s27m2.dat,1379,0.18170952796936035,850,750,100,100.0,0.0
s27m3.dat,1379,0.17678260803222656,800,810,-10,100.0,0.0
s28m0.dat,1379,0.1475386619567871,320,320,0,100.0,0.0
s28m1.dat,1379,0.1464681625366211,320,340,-20,100.0,0.0
s28m2.dat,1379,0.14549612998962402,370,350,20,100.0,0.0
s28m3.dat,1379,0.13093137741088867,440,400,40,100.0,0.0
s29m0.dat,1379,0.13670802116394043,305,335,-30,100.0,0.0
s29m1.dat,1379,0.15623927116394043,305,315,-10,100.0,0.0
s29m2.dat,1379,0.14929866790771484,305,305,0,100.0,0.0
s29m3.dat,1379,0.13475465774536133,305,345,-40,100.0,0.0
s2m0.dat,1379,0.2031264305114746,710,600,110,100.0,0.0
s2m1.dat,1379,0.21190571784973145,690,700,-10,100.0,0.0
s2m2.dat,1379,0.19141459465026855,700,670,30,100.0,0.0
s2m3.dat,1379,0.20514965057373047,650,710,-60,100.0,0.0
s30m0.dat,1379,0.19340062141418457,660,700,-40,100.0,0.0
s30m1.dat,1379,0.1894376277923584,660,740,-80,100.0,0.0
s30m2.dat,1379,0.173814058303833,760,740,20,100.0,0.0
s30m3.dat,1379,0.2079942226409912,790,760,30,100.0,0.0
s31m0.dat,1379,0.1620190143585205,485,425,60,100.0,0.0
s31m1.dat,1379,0.1611180305480957,525,475,50,100.0,0.0
s31m2.dat,1379,0.1592421531677246,495,455,40,100.0,0.0
s31m3.dat,1379,0.1846480369567871,505,585,-80,100.0,0.0
s32m0.dat,1379,0.17487096786499023,590,670,-80,100.0,0.0
s32m1.dat,1379,0.169020414352417,640,660,-20,100.0,0.0
s32m2.dat,1379,0.172929048538208,700,670,30,100.0,0.0
s32m3.dat,1379,0.16310954093933105,650,650,0,100.0,0.0
s33m0.dat,1379,0.16503024101257324,520,530,-10,100.0,0.0
s33m1.dat,1379,0.19733572006225586,480,500,-20,100.0,0.0
s33m2.dat,1379,0.15241098403930664,570,550,20,100.0,0.0
s33m3.dat,1379,0.1435403823852539,560,500,60,100.0,0.0
s34m0.dat,1379,0.15233731269836426,410,550,-140,100.0,0.0
s34m1.dat,1379,0.15921449661254883,470,500,-30,100.0,0.0
s34m2.dat,1379,0.15336036682128906,440,520,-80,100.0,0.0
s34m3.dat,1379,0.1573026180267334,440,550,-110,100.0,0.0
s35m0.dat,1379,0.11229538917541504,250,310,-60,100.0,0.0
s35m1.dat,1379,0.11429357528686523,260,320,-60,100.0,0.0
s35m2.dat,1379,0.11625862121582031,300,220,80,100.0,0.0
s35m3.dat,1379,0.11140990257263184,230,250,-20,100.0,0.0
s36m0.dat,1379,0.17975449562072754,535,595,-60,100.0,0.0
s36m1.dat,1379,0.17386293411254883,595,605,-10,100.0,0.0
s36m2.dat,1379,0.18464159965515137,625,545,80,100.0,0.0
s36m3.dat,1379,0.17860007286071777,585,525,60,100.0,0.0
s37m0.dat,1379,0.16893243789672852,375,405,-30,100.0,0.0
s37m1.dat,1379,0.13679027557373047,415,325,90,100.0,0.0
s37m2.dat,1379,0.13963651657104492,425,445,-20,100.0,0.0
s37m3.dat,1379,0.13868069648742676,405,395,10,100.0,0.0
s38m0.dat,1379,0.12115979194641113,330,270,60,100.0,0.0
s38m1.dat,1379,0.12995195388793945,280,370,-90,100.0,0.0
s38m2.dat,1379,0.13175320625305176,340,300,40,100.0,0.0
s38m3.dat,1379,0.15234160423278809,390,380,10,100.0,0.0
s39m0.dat,1379,0.17092061042785645,510,580,-70,100.0,0.0
s39m1.dat,1379,0.14555096626281738,520,460,60,100.0,0.0
s39m2.dat,1379,0.1445176601409912,380,540,-160,100.0,0.0
s39m3.dat,1379,0.1573014259338379,430,450,-20,100.0,0.0
s3m0.dat,1379,0.17572855949401855,615,715,-100,100.0,0.0
s3m1.dat,1379,0.17353510856628418,575,575,0,100.0,0.0
s3m2.dat,1379,0.18172240257263184,605,695,-90,100.0,0.0
s3m3.dat,1379,0.1844794750213623,595,615,-20,100.0,0.0
s40m0.dat,1379,0.15042567253112793,580,530,50,100.0,0.0
s40m1.dat,1379,0.15331053733825684,550,640,-90,100.0,0.0
s40m2.dat,1379,0.14939618110656738,540,610,-70,100.0,0.0
s40m3.dat,1379,0.15337729454040527,600,580,20,100.0,0.0
s41m0.dat,1379,0.1348421573638916,495,435,60,100.0,0.0
s41m1.dat,1379,0.13483738899230957,395,380,15,100.0,0.0
s41m2.dat,1379,0.12987089157104492,435,415,20,100.0,0.0
s41m3.dat,1379,0.17877960205078125,425,455,-30,100.0,0.0
s42m0.dat,1379,0.1543731689453125,460,520,-60,100.0,0.0
s42m1.dat,1379,0.16795945167541504,460,540,-80,100.0,0.0
s42m2.dat,1379,0.1835930347442627,520,530,-10,100.0,0.0
s42m3.dat,1379,0.17284631729125977,550,580,-30,100.0,0.0
s43m0.dat,1379,0.21295380592346191,375,335,40,100.0,0.0
s43m1.dat,1379,0.18754291534423828,335,335,0,100.0,0.0
s43m2.dat,1379,0.16706037521362305,335,385,-50,100.0,0.0
s43m3.dat,1379,0.16706037521362305,365,335,30,100.0,0.0
s44m0.dat,1379,0.20119857788085938,540,500,40,100.0,0.0
s44m1.dat,1379,0.16507267951965332,500,560,-60,100.0,0.0
s44m2.dat,1379,0.21483111381530762,510,560,-50,100.0,0.0
s44m3.dat,1379,0.20401239395141602,430,500,-70,100.0,0.0
s45m0.dat,1379,0.2148268222808838,500,480,20,100.0,0.0
s45m1.dat,1379,0.23728466033935547,440,440,0,100.0,0.0
s45m2.dat,1379,0.26901674270629883,560,450,110,100.0,0.0
s45m3.dat,1379,0.23241329193115234,470,480,-10,100.0,0.0
s46m0.dat,1379,0.12108254432678223,215,190,25,100.0,0.0
s46m1.dat,1379,0.12015891075134277,280,255,25,100.0,0.0
s46m2.dat,1379,0.16406559944152832,170,250,-80,100.0,0.0
s46m3.dat,1379,0.12499189376831055,200,260,-60,100.0,0.0
s47m0.dat,1379,0.16990375518798828,240,310,-70,100.0,0.0
s47m1.dat,1379,0.12411093711853027,280,260,20,100.0,0.0
s47m2.dat,1379,0.12498784065246582,240,240,0,100.0,0.0
s47m3.dat,1379,0.12598085403442383,280,230,50,100.0,0.0
s48m0.dat,1379,0.14362478256225586,325,335,-10,100.0,0.0
s48m1.dat,1379,0.13875913619995117,275,320,-45,100.0,0.0
s48m2.dat,1379,0.13580894470214844,295,350,-55,100.0,0.0
s48m3.dat,1379,0.12401938438415527,330,305,25,100.0,0.0
s49m0.dat,1379,0.14651179313659668,480,445,35,100.0,0.0
s49m1.dat,1379,0.14647769927978516,520,500,20,100.0,0.0
s49m2.dat,1379,0.1608426570892334,555,410,145,100.0,0.0
s49m3.dat,1379,0.16209936141967773,440,420,20,100.0,0.0
s4m0.dat,1379,0.23249220848083496,610,740,-130,100.0,0.0
s4m1.dat,1379,0.19138860702514648,620,660,-40,100.0,0.0
s4m2.dat,1379,0.2011561393737793,630,640,-10,100.0,0.0
s4m3.dat,1379,0.1934366226196289,700,650,50,100.0,0.0
s50m0.dat,1379,0.13191747665405273,335,345,-10,100.0,0.0
s50m1.dat,1379,0.12206196784973145,375,310,65,100.0,0.0
s50m2.dat,1379,0.1279914379119873,345,290,55,100.0,0.0
s50m3.dat,1379,0.12702202796936035,325,305,20,100.0,0.0
s51m0.dat,1379,0.17577648162841797,395,445,-50,100.0,0.0
s51m1.dat,1379,0.11717915534973145,465,485,-20,100.0,0.0
s51m2.dat,1379,0.11905312538146973,455,425,30,100.0,0.0
s51m3.dat,1379,0.12311553955078125,415,355,60,100.0,0.0
s52m0.dat,1379,0.1777191162109375,490,480,10,100.0,0.0
s52m1.dat,1379,0.17479395866394043,560,530,30,100.0,0.0
s52m2.dat,1379,0.2588164806365967,460,540,-80,100.0,0.0
s52m3.dat,1379,0.19535613059997559,570,470,100,100.0,0.0
s53m0.dat,1379,0.16511201858520508,375,395,-20,100.0,0.0
s53m1.dat,1379,0.15729069709777832,405,375,30,100.0,0.0
s53m2.dat,1379,0.2060079574584961,415,365,50,100.0,0.0
s53m3.dat,1379,0.1494274139404297,455,415,40,100.0,0.0
s54m0.dat,1379,0.12117648124694824,265,280,-15,100.0,0.0
s54m1.dat,1379,0.12596511840820312,265,275,-10,100.0,0.0
s54m2.dat,1379,0.12401986122131348,265,300,-35,100.0,0.0
s54m3.dat,1379,0.12994909286499023,315,280,35,100.0,0.0
s55m0.dat,1379,0.10253071784973145,185,180,5,100.0,0.0
s55m1.dat,1379,0.11522531509399414,170,165,5,100.0,0.0
s55m2.dat,1379,0.12195682525634766,165,185,-20,100.0,0.0
s55m3.dat,1379,0.11522769927978516,165,165,0,100.0,0.0
s56m0.dat,1379,0.23142766952514648,790,880,-90,100.0,0.0
s56m1.dat,1379,0.22286295890808105,800,810,-10,100.0,0.0
s56m2.dat,1379,0.22069692611694336,740,780,-40,100.0,0.0
s56m3.dat,1379,0.3085801601409912,775,830,-55,100.0,0.0
s57m0.dat,1379,0.18253183364868164,490,440,50,100.0,0.0
s57m1.dat,1379,0.16707086563110352,470,430,40,100.0,0.0
s57m2.dat,1379,0.17479681968688965,430,440,-10,100.0,0.0
s57m3.dat,1379,0.17878079414367676,490,440,50,100.0,0.0
s58m0.dat,1379,0.1923964023590088,410,470,-60,100.0,0.0
s58m1.dat,1379,0.18561267852783203,450,510,-60,100.0,0.0
s58m2.dat,1379,0.1904137134552002,400,470,-70,100.0,0.0
s58m3.dat,1379,0.18943572044372559,500,400,100,100.0,0.0
s59m0.dat,1379,0.21678376197814941,445,505,-60,100.0,0.0
s59m1.dat,1379,0.20620417594909668,505,455,50,100.0,0.0
s59m2.dat,1379,0.22876310348510742,525,515,10,100.0,0.0
s59m3.dat,1379,0.2177588939666748,565,525,40,100.0,0.0
s5m0.dat,1379,0.1923961639404297,435,435,0,100.0,0.0
s5m1.dat,1379,0.6703429222106934,435,465,-30,100.0,0.0
s5m2.dat,1379,0.432589054107666,465,435,30,100.0,0.0
s5m3.dat,1379,0.47164225578308105,435,435,0,100.0,0.0
s60m0.dat,1379,0.3340628147125244,365,445,-80,100.0,0.0
s60m1.dat,1379,0.21122097969055176,315,415,-100,100.0,0.0
s60m2.dat,1379,0.2549476623535156,395,315,80,100.0,0.0
s60m3.dat,1379,0.24118971824645996,345,385,-40,100.0,0.0
s61m0.dat,1379,0.23923802375793457,465,465,0,100.0,0.0
s61m1.dat,1379,0.1826779842376709,455,415,40,100.0,0.0
s61m2.dat,1379,0.19530153274536133,375,405,-30,100.0,0.0
s61m3.dat,1379,0.1581892967224121,395,415,-20,100.0,0.0
s62m0.dat,1379,0.2099449634552002,505,505,0,100.0,0.0
s62m1.dat,1379,0.19440722465515137,415,455,-40,100.0,0.0
s62m2.dat,1379,0.19724583625793457,485,435,50,100.0,0.0
s62m3.dat,1379,0.2333812713623047,445,455,-10,100.0,0.0
s63m0.dat,1379,0.17275500297546387,255,285,-30,100.0,0.0
s63m1.dat,1379,0.19041728973388672,275,215,60,100.0,0.0
s63m2.dat,1379,0.16308212280273438,285,255,30,100.0,0.0
s63m3.dat,1379,0.1932659149169922,275,335,-60,100.0,0.0
s64m0.dat,1379,0.553682804107666,445,485,-40,100.0,0.0
s64m1.dat,1379,0.4784739017486572,435,485,-50,100.0,0.0
s64m2.dat,1379,0.6395969390869141,515,405,110,100.0,0.0
s64m3.dat,1379,0.8563747406005859,395,515,-120,100.0,0.0
s65m0.dat,1379,0.5976059436798096,500,510,-10,100.0,0.0
s65m1.dat,1379,0.55660080909729,570,560,10,100.0,0.0
s65m2.dat,1379,0.3359096050262451,540,700,-160,100.0,0.0
s65m3.dat,1379,0.24313783645629883,540,470,70,100.0,0.0
s66m0.dat,1379,0.2324693202972412,500,510,-10,100.0,0.0
s66m1.dat,1379,0.2197132110595703,570,500,70,100.0,0.0
s66m2.dat,1379,0.2822434902191162,530,620,-90,100.0,0.0
s66m3.dat,1379,0.22751903533935547,530,490,40,100.0,0.0
s67m0.dat,1379,0.2343730926513672,585,685,-100,100.0,0.0
s67m1.dat,1379,0.226546049118042,705,715,-10,100.0,0.0
s67m2.dat,1379,0.21678495407104492,655,655,0,100.0,0.0
s67m3.dat,1379,0.28424596786499023,635,625,10,100.0,0.0
s68m0.dat,1379,0.21870207786560059,560,500,60,100.0,0.0
s68m1.dat,1379,0.3115115165710449,500,530,-30,100.0,0.0
s68m2.dat,1379,0.2304363250732422,470,490,-20,100.0,0.0
s68m3.dat,1379,0.20598578453063965,400,540,-140,100.0,0.0
s69m0.dat,1379,0.284149169921875,445,535,-90,100.0,0.0
s69m1.dat,1379,0.25290870666503906,525,475,50,100.0,0.0
s69m2.dat,1379,0.519507646560669,475,525,-50,100.0,0.0
s69m3.dat,1379,0.47457289695739746,395,475,-80,100.0,0.0
s6m0.dat,1379,0.8026807308197021,645,565,80,100.0,0.0
s6m1.dat,1379,0.4219350814819336,675,655,20,100.0,0.0
s6m2.dat,1379,0.30467867851257324,605,645,-40,100.0,0.0
s6m3.dat,1379,0.2519512176513672,645,595,50,100.0,0.0
s70m0.dat,1379,0.16894769668579102,490,460,30,100.0,0.0
s70m1.dat,1379,0.2136859893798828,520,430,90,100.0,0.0
s70m2.dat,1379,0.15526080131530762,490,540,-50,100.0,0.0
s70m3.dat,1379,0.18462061882019043,550,490,60,100.0,0.0
s71m0.dat,1379,0.1907329559326172,575,645,-70,100.0,0.0
s71m1.dat,1379,0.21580958366394043,595,645,-50,100.0,0.0
s71m2.dat,1379,0.2519347667694092,565,485,80,100.0,0.0
s71m3.dat,1379,0.2148265838623047,585,615,-30,100.0,0.0
s72m0.dat,1379,0.21784090995788574,555,595,-40,100.0,0.0
s72m1.dat,1379,0.20906782150268555,585,605,-20,100.0,0.0
s72m2.dat,1379,0.21686196327209473,615,555,60,100.0,0.0
s72m3.dat,1379,0.28033447265625,645,555,90,100.0,0.0
s73m0.dat,1379,0.1650247573852539,310,340,-30,100.0,0.0
s73m1.dat,1379,0.17977404594421387,415,470,-55,100.0,0.0
s73m2.dat,1379,0.14061331748962402,275,330,-55,100.0,0.0
s73m3.dat,1379,0.13865995407104492,335,350,-15,100.0,0.0
s74m0.dat,1379,0.1894385814666748,485,535,-50,100.0,0.0
s74m1.dat,1379,0.18754172325134277,515,585,-70,100.0,0.0
s74m2.dat,1379,0.18749260902404785,635,545,90,100.0,0.0
s74m3.dat,1379,0.1874845027923584,465,485,-20,100.0,0.0
s75m0.dat,1379,0.2080540657043457,465,485,-20,100.0,0.0
s75m1.dat,1379,0.1699082851409912,415,405,10,100.0,0.0
s75m2.dat,1379,0.1699085235595703,405,405,0,100.0,0.0
s75m3.dat,1379,0.1747734546661377,395,395,0,100.0,0.0
s76m0.dat,1379,0.16698718070983887,355,355,0,100.0,0.0
s76m1.dat,1379,0.1620960235595703,325,335,-10,100.0,0.0
s76m2.dat,1379,0.1807422637939453,395,385,10,100.0,0.0
s76m3.dat,1379,0.1738138198852539,375,325,50,100.0,0.0
s77m0.dat,1379,0.2724637985229492,815,735,80,100.0,0.0
s77m1.dat,1379,0.30858850479125977,775,745,30,100.0,0.0
s77m2.dat,1379,0.2978231906890869,840,755,85,100.0,0.0
s77m3.dat,1379,0.28025174140930176,795,795,0,100.0,0.0
s78m0.dat,1379,0.229478120803833,470,490,-20,100.0,0.0
s78m1.dat,1379,0.25290632247924805,550,420,130,100.0,0.0
s78m2.dat,1379,0.2656712532043457,470,410,60,100.0,0.0
s78m3.dat,1379,0.31247925758361816,500,450,50,100.0,0.0
s79m0.dat,1379,0.32038450241088867,260,290,-30,100.0,0.0
s79m1.dat,1379,0.20804142951965332,310,355,-45,100.0,0.0
s79m2.dat,1379,0.14053821563720703,255,320,-65,100.0,0.0
s79m3.dat,1379,0.1415882110595703,350,340,10,100.0,0.0
s7m0.dat,1379,0.1777195930480957,485,505,-20,100.0,0.0
s7m1.dat,1379,0.2891252040863037,445,465,-20,100.0,0.0
s7m2.dat,1379,0.2822141647338867,415,495,-80,100.0,0.0
s7m3.dat,1379,0.22956562042236328,495,495,0,100.0,0.0
s80m0.dat,1379,0.2734670639038086,730,770,-40,100.0,0.0
s80m1.dat,1379,0.22161602973937988,760,700,60,100.0,0.0
s80m2.dat,1379,0.21686410903930664,740,740,0,100.0,0.0
s80m3.dat,1379,0.21579885482788086,810,720,90,100.0,0.0
s81m0.dat,1379,0.20818686485290527,605,545,60,100.0,0.0
s81m1.dat,1379,0.20705676078796387,495,725,-230,100.0,0.0
s81m2.dat,1379,0.20506501197814941,675,675,0,100.0,0.0
s81m3.dat,1379,0.2078990936279297,635,545,90,100.0,0.0
s82m0.dat,1379,0.18163800239562988,365,345,20,100.0,0.0
s82m1.dat,1379,0.1845541000366211,425,425,0,100.0,0.0
s82m2.dat,1379,0.23563456535339355,375,375,0,100.0,0.0
s82m3.dat,1379,0.18171954154968262,365,365,0,100.0,0.0
s83m0.dat,1379,0.29784560203552246,640,620,20,100.0,0.0
s83m1.dat,1379,0.2323312759399414,610,590,20,100.0,0.0
s83m2.dat,1379,0.23052000999450684,620,680,-60,100.0,0.0
s83m3.dat,1379,0.29303789138793945,520,590,-70,100.0,0.0
s84m0.dat,1379,0.25388598442077637,855,825,30,100.0,0.0
s84m1.dat,1379,0.24713516235351562,855,775,80,100.0,0.0
s84m2.dat,1379,0.2744870185852051,805,755,50,100.0,0.0
s84m3.dat,1379,0.25290870666503906,865,785,80,100.0,0.0
s85m0.dat,1379,0.2040858268737793,465,465,0,100.0,0.0
s85m1.dat,1379,0.20017576217651367,415,485,-70,100.0,0.0
s85m2.dat,1379,0.1952531337738037,525,485,40,100.0,0.0
s85m3.dat,1379,0.1962742805480957,585,585,0,100.0,0.0
s86m0.dat,1379,0.17097687721252441,470,350,120,100.0,0.0
s86m1.dat,1379,0.17389369010925293,460,360,100,100.0,0.0
s86m2.dat,1379,0.170884370803833,390,410,-20,100.0,0.0
s86m3.dat,1379,0.24119305610656738,460,380,80,100.0,0.0
s87m0.dat,1379,0.3251667022705078,830,920,-90,100.0,0.0
s87m1.dat,1379,0.3437082767486572,880,850,30,100.0,0.0
s87m2.dat,1379,0.26299190521240234,830,900,-70,100.0,0.0
s87m3.dat,1379,0.2577946186065674,850,850,0,100.0,0.0
s88m0.dat,1379,0.18365788459777832,420,400,20,100.0,0.0
s88m1.dat,1379,0.15917706489562988,410,440,-30,100.0,0.0
s88m2.dat,1379,0.21653962135314941,420,350,70,100.0,0.0
s88m3.dat,1379,0.16210317611694336,500,450,50,100.0,0.0
s89m0.dat,1379,0.15713977813720703,315,385,-70,100.0,0.0
s89m1.dat,1379,0.16015172004699707,335,425,-90,100.0,0.0
s89m2.dat,1379,0.1602332592010498,355,375,-20,100.0,0.0
s89m3.dat,1379,0.15828561782836914,355,345,10,100.0,0.0
s8m0.dat,1379,0.1494002342224121,380,400,-20,100.0,0.0
s8m1.dat,1379,0.1485137939453125,320,380,-60,100.0,0.0
s8m2.dat,1379,0.15632247924804688,390,370,20,100.0,0.0
s8m3.dat,1379,0.15039491653442383,360,390,-30,100.0,0.0
s90m0.dat,1379,0.13670587539672852,215,245,-30,100.0,0.0
s90m1.dat,1379,0.13668203353881836,235,205,30,100.0,0.0
s90m2.dat,1379,0.13768243789672852,205,205,0,100.0,0.0
s90m3.dat,1379,0.13670730590820312,205,205,0,100.0,0.0
s91m0.dat,1379,0.13279366493225098,320,230,90,100.0,0.0
s91m1.dat,1379,0.1328110694885254,250,270,-20,100.0,0.0
s91m2.dat,1379,0.1328432559967041,270,260,10,100.0,0.0
s91m3.dat,1379,0.13285565376281738,240,290,-50,100.0,0.0
s92m0.dat,1379,0.2565622329711914,605,545,60,100.0,0.0
s92m1.dat,1379,0.23638629913330078,595,485,110,100.0,0.0
s92m2.dat,1379,0.22734689712524414,505,495,10,100.0,0.0
s92m3.dat,1379,0.1933448314666748,575,525,50,100.0,0.0
s93m0.dat,1379,0.1718883514404297,585,595,-10,100.0,0.0
s93m1.dat,1379,0.17096662521362305,545,525,20,100.0,0.0
s93m2.dat,1379,0.16999197006225586,615,595,20,100.0,0.0
s93m3.dat,1379,0.16601061820983887,545,575,-30,100.0,0.0
s94m0.dat,1379,0.1972517967224121,760,710,50,100.0,0.0
s94m1.dat,1379,0.20221710205078125,720,790,-70,100.0,0.0
s94m2.dat,1379,0.20026493072509766,740,760,-20,100.0,0.0
s94m3.dat,1379,0.19238615036010742,770,840,-70,100.0,0.0
s95m0.dat,1379,0.1620950698852539,460,445,15,100.0,0.0
s95m1.dat,1379,0.16411519050598145,430,475,-45,100.0,0.0
s95m2.dat,1379,0.15623736381530762,445,375,70,100.0,0.0
s95m3.dat,1379,0.15534424781799316,390,465,-75,100.0,0.0
s96m0.dat,1379,0.1874833106994629,520,550,-30,100.0,0.0
s96m1.dat,1379,0.1856098175048828,500,600,-100,100.0,0.0
s96m2.dat,1379,0.1865072250366211,580,570,10,100.0,0.0
s96m3.dat,1379,0.20018982887268066,590,520,70,100.0,0.0
s97m0.dat,1379,0.1454939842224121,380,440,-60,100.0,0.0
s97m1.dat,1379,0.14356708526611328,360,330,30,100.0,0.0
s97m2.dat,1379,0.14461398124694824,360,410,-50,100.0,0.0
s97m3.dat,1379,0.14540743827819824,410,350,60,100.0,0.0
s98m0.dat,1379,0.23444128036499023,625,565,60,100.0,0.0
s98m1.dat,1379,0.1855318546295166,585,545,40,100.0,0.0
s98m2.dat,1379,0.21385550498962402,645,535,110,100.0,0.0
s98m3.dat,1379,0.1767442226409912,615,585,30,100.0,0.0
s99m0.dat,1379,0.15135431289672852,355,395,-40,100.0,0.0
s99m1.dat,1379,0.14647245407104492,335,315,20,100.0,0.0
s99m2.dat,1379,0.14549589157104492,365,365,0,100.0,0.0
s99m3.dat,1379,0.14362716674804688,345,300,45,100.0,0.0
s9m0.dat,1379,0.16112518310546875,480,490,-10,100.0,0.0
s9m1.dat,1379,0.15730643272399902,460,440,20,100.0,0.0
s9m2.dat,1379,0.1689310073852539,510,420,90,100.0,0.0
s9m3.dat,1379,0.17666387557983398,410,480,-70,100.0,0.0
